Total Items (JSON): 76
custom-report-builder|OK|app.scenarios.custom_report_builder
text-to-date-converter|OK|app.scenarios.text_to_date
concatenate-columns|OK|app.scenarios.concatenate_columns
calculate-growth-rate|OK|app.scenarios.calculate_growth_rate
average-condition|OK|app.scenarios.average_condition
sum-between-dates|OK|app.scenarios.sum_between_dates
average-ifs|OK|app.scenarios.average_ifs
basic-summary-stats-column|OK|app.scenarios.basic_summary_stats_column
bucket-dates-into-periods|OK|app.scenarios.bucket_dates_into_periods
bucketing-numeric-into-bands|OK|app.scenarios.bucketing_numeric_into_bands
check-missing-values|OK|app.scenarios.check_missing_values
color-scale-by-value|OK|app.scenarios.color_scale_by_value
column-chart-by-category|OK|app.scenarios.column_chart_by_category
compute-age-from-dob|OK|app.scenarios.compute_age_from_dob
correlation-two-columns|OK|app.scenarios.correlation_two_columns
count-nonblank-column|OK|app.scenarios.count_nonblank_column
count-rows-multi|OK|app.scenarios.count_rows_multi
count-value|OK|app.scenarios.count_value
create-segment-column-by-thresholds|OK|app.scenarios.create_segment_column_by_thresholds
days-between-dates|OK|app.scenarios.days_between_dates
detect-out-of-range|OK|app.scenarios.detect_out_of_range
distinct-count-by-group|OK|app.scenarios.distinct_count_by_group
extract-text-before-after|OK|app.scenarios.extract_text_before_after
fallback-lookup|OK|app.scenarios.fallback_lookup
fill-missing-dates|OK|app.scenarios.fill_missing_dates
filter-rows-by-condition|OK|app.scenarios.filter_rows_by_condition
find-and-replace-substring|OK|app.scenarios.find_and_replace_substring
find-duplicates-multi-column|OK|app.scenarios.find_duplicates_multi_column
frequency-table|OK|app.scenarios.frequency_table_single_column
sum-multi|OK|app.scenarios.sum_multi
find-inconsistent-casing|OK|app.scenarios.find_inconsistent_casing
flag-rows-that-meet-rule|OK|app.scenarios.flag_rows_that_meet_rule
frequency-table-multi-column|OK|app.scenarios.frequency_table_multi_column
frequency-table-single-column|OK|app.scenarios.frequency_table_single_column
group-by-month-year|OK|app.scenarios.group_by_month_year
highlight-duplicates|OK|app.scenarios.highlight_duplicates
highlight-top-bottom-n|OK|app.scenarios.highlight_top_bottom_n
highlight-values-by-threshold|OK|app.scenarios.highlight_values_by_threshold
join-two-tables-key|OK|app.scenarios.join_two_tables_key
keep-uniques-only|OK|app.scenarios.keep_uniques_only
max-min-if|OK|app.scenarios.max_min_if
multi-column-lookup|OK|app.scenarios.multi_column_lookup
multi-condition-label-if|OK|app.scenarios.multi_condition_label_if
normalize-case|OK|app.scenarios.normalize_case
outlier-flagging|OK|app.scenarios.outlier_flagging
pareto-chart-top-contributors|OK|app.scenarios.pareto_chart_top_contributors
percentiles-and-quartiles|OK|app.scenarios.percentiles_and_quartiles
pivot-multi-level|OK|app.scenarios.pivot_multi_level
pivot-sum-by-category|OK|app.scenarios.pivot_sum_by_category
pivot-with-percentage-of-total|OK|app.scenarios.pivot_with_percentage_of_total
pivot-with-subtotals|OK|app.scenarios.pivot_with_subtotals
pq-append-tables|OK|app.scenarios.pq_append_tables
pq-unpivot-columns|OK|app.scenarios.pq_unpivot_columns
remove-duplicates-keeping-first|OK|app.scenarios.remove_duplicates_keeping_first
report-filter-then-group|OK|app.scenarios.report_filter_then_group
report-group-summary|OK|app.scenarios.report_group_summary
report-multi-metric-summary|OK|app.scenarios.report_multi_metric_summary
report-pivot-matrix-count|OK|app.scenarios.report_pivot_matrix_count
report-pivot-matrix-sum|OK|app.scenarios.report_pivot_matrix_sum
reverse-lookup-last-match|OK|app.scenarios.reverse_lookup_last_match
running-total-by-group|OK|app.scenarios.running_total_by_group
score-cards-weighted-points|OK|app.scenarios.score_cards_weighted_points
simple-line-chart-time|OK|app.scenarios.simple_line_chart_time
sort-by-multiple-columns|OK|app.scenarios.sort_by_multiple_columns
split-column-by-delimiter|OK|app.scenarios.split_column_by_delimiter
stacked-column-by-category|OK|app.scenarios.stacked_column_by_category
sum-if|OK|app.scenarios.sum_if
sum-ifs-multi|OK|app.scenarios.sum_ifs_multi
summarize-by-month-and-category|OK|app.scenarios.summarize_by_month_and_category
tag-first-occurrence|OK|app.scenarios.tag_first_occurrence
trim-clean-text|OK|app.scenarios.trim_clean_text
unique-list-with-counts|OK|app.scenarios.unique_list_with_counts
validate-values-against-list|OK|app.scenarios.validate_values_against_list
vlookup-single-match|OK|app.scenarios.vlookup_single_match
xlookup-single-match|OK|app.scenarios.xlookup_single_match
zscore-standardization|OK|app.scenarios.zscore_standardization
